Gll^Fp, Gll^Fp, Gll^Fmw, Gll^Fmw, Gll^Fmw, Gll^Fp, Re^Em, Gs^Fmw, Gg^Fms, Gg^Efm, Gg^Fms, Gg^Fms, Gg^Fms, Gs^Fds, Gg, Ww, Wo, Wo, Ww, Gd^Fdw, Gd, Gs, Gs^Fmw, Gg^Efm, Gll^Fms, Gll^Fms, Gs^Fds, Hh^Fp, Mm, Mm, Mm, Hh, Mm, Hh^Fmw, Mm, Mm, Mm
Gll^Fdw, Gll^Fmw, Gll^Fp, Gll^Fp, Ss^Em, Ss^Em, Re^Em, Gs^Fmw, Gs^Fp, Gg, Gg^Efm, Gs^Fds, Gs^Fds, Gg^Efm, Gs, Gs^Fds, Ww, Wo, Ww, Ds, Re^Es, Gs^Fdw, Gs^Fp, Gs^Fms, Gg^Fms, Hh^Fms, Hh, Hh^Fms, Hh^Fds, Mm, Mm, Mm, Hh^Fmw, Hh^Fms, Hh^Fmw, Mm, Mm
Gll^Fdw, Gll^Fmw, Gll^Fp, Sm^Em, Gll^Fdw, Ss^Tf, Ss^Em, Rr, Rp, Rr, Rr, Gs^Vh, Gs^Fmw, Gs, Gs, Gd, Ds, Wo, Wo, Ds^Esd, Re^Fdw, Gd, Gs^Fms, Gs^Fms, Gll^Fp, Gs^Fms, Hh, Gs^Fds, Gs^Fms, Hh, Mm, Gll^Emf, Gll^Fdw, Hh, Hh^Fmw, Gll^Emf, Hh^Fmw
Ss^Tf, Ss^Tf, Ss^Em, Sm^Edb, Ss, Gll^Fmw, Ss, Ss, Gll^Fmw, Gll^Fmw, Re^Es, Rp, Gs, Gg^Efm, Gg^Efm, Gd, Gs^Fmw, Ww^Ewl, Ww, Ds, Gd, Gs^Fmw, Gd, Gs^Fds, Gs^Fp, Gs^Fms, Gd^Dr, Gs^Edt, Gll^Es, Gs^Fms, Hh^Fdw, Hh^Fp, Gs^Em, Hh, Gs, Gs^Em, Gs^Fp
Ss^Em, Ss^Em, Sm^Edb, Ss^Edb, Rr^Ve, Ss^Edb, Ss^Efm, Rb^Fdw, Rb^Fmw, Gll^Fp, Gll^Fp, Rp, Gs^Efm, Gs^Fmw, Gs, Gs, Gs, Ds^Esd, Ww, Ww, Ds, Gd^Fmw, Gs^Fmw, Gll^Em, Gs^Fms, Gll^Edt, Gd^Dr, Gg^Dr, Gs^Es, Gs^Fp, Gs^Fmw, Gs^Fp, Rrc^Es, Rr, Rr, Gs^Fp, Rp
Ss^Em, Gll^Fmw, Sm^Em, Kv, Ce, Rp, Sm^Em, Ss^Em, Ss^Tf, Gll^Fmw, Gll^Fmw, Rr, Rr, Gs, Gd^Fdw, Gs^Fmw, Gd^Es, Re, Wo, Wo, Ds^Esd, Re, Gs^Eff, Gs^Eff, Gs^Eff, Gll^Es, Gg^Es, Gs^Es, Gs^Efm, Gd^Efm, Rr, Rr^Es, Gg, Gs^Vht, Gg^Efm, Rp, Gg
Ss, Gll^Fmw, Gll^Fmw, Ce, Rrc, Rrc, Rrc, Ss^Em, Rrc, Hh^Fdw, Rrc, Rr, Gd, Rrc, Gd, Ds^Esd, Ww, Ww, Wo, Ww, Gs^Eff, Gs^Eff, Re^Gvs, Re^Gvs, Re^Wm, Gs^Eff, Gs^Eff, Gs, Gs, Rp, Rr^Es, Gg, Gg, Gg, Gg, Gg, Gg
Gll^Fmw, Gll^Fdw, Gll^Fmw, Gs^Fet, Gd^Gvs, Gd^Ebn, Sm^Efm, Rr, Sm^Em, Rr, Rb^Es, Gd, Gll^Fmw, Rr, Rrc, Ds, Wo, Wo, Ww, Ds^Eff, Gd^Eff, Re^Gvs, Re^Es, Re^Es, Re^Gvs, Re^Gvs, Gs^Eff, Gs^Eff, Gg^Efm, Gg^Efm, Gs^Fdw, Rrc, Gg^Efm, Gg^Efm, Gs^Fp, Gg, Gs
Re^Es, Gd^Es, Gll^Fdw, Hh^Fdw, Ss^Em, Ss, Hh^Es, Sm^Edb, Hh^Em, Sm^Em, Rb^Fdw, Gll^Fmw, Gll^Fp, Gll^Fp, Rr, Ds, Ww^Bw/, Wo, Wo, Ds, Ds, Gd^Eff, Gs^Eff, Re^Gvs, Gs^Eff, Gg^Vh, Rr^Es, Gs, Rrc, Gs^Fdw, Rp, Rp, Gs^Fms, Gs, Gs, Gg, Gg^Em
Ss^Em, Gll^Fmw, Gll^Fmw, Ss^Edb, Ss^Em, Hh^Fdw, Sm^Em, Hh^Es, Hh^Fmw, Gll^Emf, Hh^Fmw, Hh, Gs^Fp, Gd, Rrc, Gd^Fms, Rr^Vl, Ww, Wo, Wo, Wo, Gd, Kh, Gs^Eff, Rrc, Rrc, Gs^Eff, Rr^Es, Gg^Em, Rrc, Gs^Fp, Gs^Em, Gs^Fms, Gs^Fms, Gs^Fms, Gs^Fp, Gs^Em
Ss, Ss, Gll^Fmw, Ss, Rb^Fdw, Sm^Efm, Gll^Fdw, Hh^Fmw, Gs^Fp, Hh^Fmw, Gs^Fp, Gs^Fp, Gs^Fms, Gs^Fms, Gs^Eff, Rr, Rrc, Rr^Es, Kh, Wo^Bw/, Wo, Wo, Wo^Bsb/, Rrc, Kh, Gs^Eff, Re^Gvs, Gs^Eff, Gd^Eff, Gs^Fdw, Gs^Fp, Gll^Em, Gll^Fp, Gs^Fms, Gs^Fds, Gll^Emf, Gll^Fms
Ss^Em, Ss^Efm, Rb^Fdw, Gd, Gll^Fmw, Rb, Hh, Hh^Fp, Hh, Gs^Fms, Gd^Em, Gs^Em, Gs^Eff, Gs^Eff, Re^Gvs, Gs^Eff, Gs^Eff, Rrc, Rrc, Isr^Ebn, Rrc^Efs, Wo^Bsb/, Wo, Wo^Efs, Gs^Eff, Re^Gvs, Re^Gvs, Re^Gvs, Gs^Eff, Gg^Eff, Gs^Fms, Gll^Fp, Gll^Fp, Gs^Fds, Gs^Fds, Gll^Fms, Gs^Fms
Ss^Em, Ss^Tf, Gll^Fdw, Gll^Fmw, Re^Es, Gll^Emf, Gll^Fmw, Gll^Fp, Gll^Emf, Gs^Fms, Gs^Fms, Gs^Eff, Rb^Eff, Re^Gvs, Re^Gvs, Re^Gvs, Rb, Kh, Isr^Vhc, Rrc, Isr^Vhc, Kh, Wo^Ewl, Wo, Ww, Gd^Eff, Gd^Eff, Gs^Eff, Gs^Fmw, Gs^Fmw, Gll^Em, Gll^Fms, Gll^Fp, Hh, Hh^Fms, Hh^Fdw, Hh^Fmw
Gll^Fmw, Gll^Fmw, Gll^Fp, Gd, Gd, Gll^Fmw, Gll^Fp, Gll^Fp, Gs^Em, Gs^Fms, Rb, Rb, Gs^Eff, Rb, Rb, Rb, Gs^Eff, Ch, Isr^Vhc, Rrc, Isr, Ch, Kh, Wo, Ww, Ds, Gd^Es, Gs, Gs^Es, Gs^Em, Gs^Fp, Re, Hh, Hh^Fmw, Mm^Fmw, Hh^Es, Hh^Es
Gll^Fmw, Gll^Fmw, Gll^Fp, Gll^Fp, Gll^Fmw, Gs^Es, Gll^Fp, Gs^Fp, Gs^Fds, Rb, Re^Eff, Gd^Eff, Re^Gvs, Re^Wm, Re^Gvs, Gs^Eff, Gg^Eff, Kh, Rrc, Rrc, Rrc, Kh, Ch, Wo, Wo, Ww, Ds, Gd, Gd^Fmw, Gs^Fms, Hh^Fms, Gll^Emf, Mm^Fmw, Hh^Fmw, Mm^Xm, Mm, Hh^Fmw
Gll^Em, Gll^Emf, Gs^Fp, Gs^Fms, Re, Gll^Fmw, Gs^Fp, Gs^Fms, Gs^Fms, Gll^Fds, Rb^Vh, Re^Eff, Re^Eff, Re^Gvs, Gs^Eff, Gs^Eff, Rrc, Rrc, Kh, Rr^Vhc, Isr, Rrc, Isr^Ebn, Ww^Bw\, Wo, Ww, Rd, Gd^Es, Hh^Es, Hh, Mm, Hh, Hh^Fdw, Mm, Mm, Mm^Fmw, Hh^Es
Gs^Fds, Gs^Fp, Gs^Fms, Gs^Es, Gs^Efm, Gs^Efm, Gs^Es, Gg^Efm, Gs^Fms, Gll^Fms, Re^Es, Re^Es, Gd^Fmw, Gd^Eff, Gs^Es, Rrc, Gg^Efm, Gg, Gg^Efm, Ch, Kh, Isr^Vhc, Wo^Bw\, Wo^Ewl, Wo, Ww^Ewl, Re^Es, Hh^Fdw, Ww^Ewf, Mm^Fmw, Ww^Ewf, Gg^Efm, Mm^Xm, Mm^Xm, Wo, Mm, Mm
Gs^Fms, Gs^Fms, Gs^Fms, Gs^Fp, Gs^Fp, Gs^Fms, Gs, Gs^Efm, Gs, Re, Rb^Edb, Rb, Re^Edb, Rb, Rr, Rr, Gs, Gs, Re^Eff, Gs, Gs, Ww^Ewl, Ww, Wo, Rd^Es, Re, Rd^Es, Hh, Ww, Ww, Hh, Hh, Mm^Fmw, Mm^Xm, Wo, Wo, Wo
Gs^Fp, Gs^Fms, Rr, Rr, Rr, Gs^Fp, Rr, Gs, Gll^Fmw, Gll^Fp, Rp, Gll^Fmw, Rr, Gll^Fmw, Rrc, Rb, Rb^Eff, Re^Eff, Re^Gvs, Re^Eff, Gd^Eff, Gs, Wo, Ds^Esd, Ds^Esd, Rd^Es, Ww, Gd, Ww^Ewl, Mm, Gg^Efm, Mm, Mm, Mm^Fmw, Gd^Vo, Gs^Fms, Ww
Re^Es, Re^Es, Gs^Em, Gs^Fms, Gs^Fp, Rr, Gll^Fp, Rr, Rrc, Rr, Rb^Fdw, Rp, Rb^Fdw, Rp, Sm^Em, Rb^Fdw, Rb^Edb, Gll^Eff, Gd^Eff, Gd^Eff, Ww, Ww, Wo, Ds, Wo, Ww, Wo, Ww, Ww, Mm^Fmw, Hh^Fmw, Mm, Mm, Mm^Fmw, Hh^Fmw, Ww, Wo^Ewf
Gs^Fms, Gs^Fms, Gll^Emf, Gs^Fms, Gs^Fp, Gs^Em, Gll^Fp, Rb^Es, Rr, Sm, Ss^Em, Ss, Ss^Em, Sm^Edb, Ss, Ss, Ss^Efm, Rb^Es, Re^Edb, Gs^Vht, Ww^Bw\, Wo, Wo, Ww, Wo, Wo, Wo, Wo, Wo, Wo, Wo, Gg^Efm, Hh, Gs^Fp, Wwrt, Wo, Gg^Fms
Gs^Fp, Gll^Fp, Gll^Fp, Gll^Fp, Gs^Fp, Gll^Fp, Gll^Fmw, Gll^Fmw, Rr, Sm^Em, Sm, Ss^Em, Rb^Emf, Rb^Fdw, Sm^Edb, Sm^Edb, Ww^Edb, Ww^Edb, Wo, Ww, Wo, Ww, Wo^Edb, Wo, Wo, Wo, Ww, Ww, Ww, Wo, Mm, Mm, Mm, Wwrt, Wwrt^Ewl, Gg^Efm, Gs^Fms
Gs^Fms, Gs^Fp, Gs^Fms, Gs^Fms, Wwf, Gll^Fp, Ww^Edb, Gll^Fmw, Rrc, Sm^Edb, Ww^Edb, Sm^Em, Ss^Em, Ss, Ww, Wo, Ww, Ww, Ww, Wo, Ww^Edb, Ww^Edb, Ww^Edb, Ww, Ww, Wo, Gd^Fmw, Gs^Fdw, Gs^Fp, Wo, Wo, Mm, Wo, Wo^Ewl, Gg^Efm, Gs^Fms, Hh^Fms
Ww, Ww^Ewf, Ww^Ewl, Wwf, Wo, Wo, Wo^Bsb/, Wwf^Bsb/, Wo^Efs, Ww^Edb, Wo, Gll^Fmw, Ss^Efm, Ww, Wo, Wo, Re^Es, Gll^Fmw, Gll^Fp, Gll^Fdw, Gll^Fmw, Gll^Fp, Gs^Fms, Re, Gs^Fms, Wwrt, Gs^Fp, Gs^Fmw, Gll^Emf, Ww, Hh^Fmw, Wo, Hh^Es, Ww, Gs^Fp, Hh^Fp, Mm
Wo, Wo^Ewl, Wo, Wo, Gs^Fmw, Rrc^Efs, Hh^Efs, Wo, Gs^Fms, Wo, Ww^Edb, Wo, Wo, Wo, Ww^Edb, Ww^Edb, Gll^Fp, Gd^Es, Gd^Es, Gll^Fdw, Gll^Fdw, Gs^Fp, Gd^Es, Gs^Efm, Ww, Wwrt, Gs^Fp, Gs^Fms, Hh^Fms, Hh^Fp, Hh^Es, Hh, Hh^Fmw, Hh^Es, Gs^Fmw, Hh^Fmw, Mm
Ww, Ww, Gs^Vh, Gs^Wm, Gs^Eff, Rr, Hh, Hh^Es, Hh^Fmw, Gs^Fms, Hh^Es, Ww^Edb, Ww, Ww^Edb, Re^Fmw, Ww^Edb, Rb^Em, Gd^Es, Gd^Es, Gd, Wwf, Wwf, Ww, Gs^Fp, Wo, Wo, Gs^Fds, Gll^Emf, Gs^Efm, Hh^Fmw, Gs^Em, Mm, Mm, Gs^Efm, Hh^Fdw, Mm, Ww^Ewl
Ww^Bw\, Ww^Ewf, Rr^Efs, Gs^Eff, Gs^Eff, Rr^Eff, Gs^Efm, Hh^Fdw, Hh^Fmw, Hh^Es, Gs^Fms, Gs^Fms, Sm, Ww^Edb, Re^Fmw, Gll^Fp, Gd^Es, Gd^Es, Gd^Eff, Gs^Eff, Gd^Vht, Ww, Ww, Ww, Wo^Ewf, Ww^Ewl, Ww, Hh^Fds, Hh^Es, Mm^Fmw, Hh^Fdw, Hh^Em, Gs, Hh^Fdw, Mm, Hh^Fmw, Hh^Fp
Hh, Rr, Rr, Gs^Fmw, Gs^Vh, Re, Gs^Fp, Hh, Re^Em, Hh^Es, Hh^Fp, Gll^Fp, Sm^Em, Rb^Es, Sm, Ss^Em, Ss^Eff, Gd^Eff, Gd^Vht, Isa^Efs, Isa^Efs, Wwf, Ww, Wo, Wo, Wo, Wo^Ewl, Hh^Fms, Mm^Fmw, Mm, Mm^Fmw, Mm^Vo, Hh, Mm, Mm, Mm^Fmw, Mm
Gs^Eff, Gs^Fms, Gs^Vht, Rr^Efs, Re, Rr, Gll^Fp, Gll^Fp, Gll^Fmw, Gll^Fmw, Hh, Gll^Fp, Gll^Fp, Sm, Gll^Emf, Gll^Fmw, Gll^Fmw, Gd^Eff, Re, Isa, Gd^Vht, Wwf, Wwf, Ww, Ww^Ewl, Ww, Mm, Wo, Mm, Mm, Mm^Fmw, Mm^Fmw, Gs^Efm, Ww, Wo, Wo, Ww
Gg^Eff, Gs^Eff, Rr, Rr, Gs^Fmw, Gll^Fp, Gll^Fdw, Gll^Fmw, Gll^Fp, Gll^Fp, Gll^Fmw, Gll^Emf, Re, Ss^Em, Re, Re, Rr, Re, Gll^Fp, Gll^Eff, Gs^Eff, Gd^Eff, Gs^Fp, Gd^Fmw, Hh^Fp, Hh^Fds, Mm, Wo, Ww, Mm, Mm, Hh, Mm^Efm, Mm, Mm^Fmw, Mm^Fmw, Hh^Fms
Rr, Re, Gs^Fp, Rp, Rr, Re, Re, Re^Em, Rr, Gll^Fmw, Rp, Rr, Gll^Fmw, Rp, Ss^Em, Ss^Em, Gll^Fmw, Rr, Rp, Gll^Fmw, Gll^Fmw, Gd^Efm, Gd, Gs^Fp, Rr, Mm, Wo, Wo, Mm^Fmw, Hh^Fmw, Hh, Gs, Mm^Fmw, Ww, Wo, Hh^Fmw, Hh^Fms
Gs^Em, Gs^Efm, Gs^Fp, Gs^Fmw, Gll^Fp, Gll^Fdw, Gll^Fmw, Ss^Em, Ss^Em, Rr, Ss^Em, Ss, Ss^Vht, Ss, Ss^Em, Gll^Emf, Gll^Fmw, Gll^Fdw, Gs^Efm, Rp, Re, Gll^Fmw, Rr, Re, Hh^Es, Rrc, Wo^Bsb\, Mm, Hh^Fp, Mm^Fmw, Gs, Mm^Fmw, Mm^Fmw, Mm, Mm, Ww, Hh^Fms
Gs^Fds, Gs^Fms, Gs^Fds, Gs^Fp, Gs^Fms, Gll^Fp, Gll^Fmw, Ss^Tf, Gll^Fmw, Ss, Sm, Sm^Em, Sm, Sm^Em, Ss^Em, Gll^Fdw, Gll^Fmw, Gll^Fmw, Gll^Fp, Gll^Fp, Gs^Fms, Re, Gs^Fds, Gs^Fms, Gs^Fp, Ww^Efs, Wo^Efs, Rrc^Efs, Gs, Hh^Fdw, Mm, Gd^Vo, Hh^Fdw, Mm^Fmw, Mm, Ww, Ww^Ewf
Gs^Fds, Gs^Fds, Gs^Fds, Gs^Fms, Gs^Fms, Gll^Fp, Gll^Fp, Gll^Fp, Gll^Fp, Ss^Tf, Ss, Sm^Em, Sm, Sm, Ss^Em, Ss^Tf, Gs^Fds, Gll^Fmw, Gll^Fp, Gll^Fp, Re, Gs^Fms, Re, Gs^Fp, Gs^Fds, Wo, Hh, Rr, Hh, Mm, Mm, Hh, Mm, Hh, Hh, Ww^Ewf, Gs^Fds
